111111111111111111111111111111
100000000011000001000010010101
111C1111111C111100000000000001
111C111C1100000000000000000001
100000000000000000000000000001
1E0000000000000000000000000001
100000000000000000P11000001001
111111111111111111111111111111